BBBBBBBBBBBBBBBBBBBBBBBBBBBBBBBBBBBBBBBBBBBBBBBBBBBBBBBBBBBBBBBB
B.X.............U.............T..X.............U.............T.B
B............C..M..C........................C..M..C............B
B...0000000000000000000000000......0000000000000000000000000...B
B...0.T...................X.0......0.T...................X.0...B
B...0..0000.....U.....0000..0......0..0000.....U.....0000..0...B
B...0..0.................0..0......0..0.................0..0...B
B...0..0.C.....0.0.....C.0..0......0..0.C.....0.0.....C.0..0...B
B...0..0.......0.0.......0..0......0..0.......0.0.......0..0...B
B...0..0.......0.0.......0..0......0..0.......0.0.......0..0...B
B...0.....000000.000000.....0......0.....000000.000000.....0...B
B.M.0..U.....1.0.0.......U..0.M..M.0..U.......0.0.......U..0.M.B
B...0......00000.00000......0......0......00000.00000......0...B
B...0..0.......0.0.......0..0......0..0.......0.0.......0..0...B
B...0..0.......0.0.......0..0......0..0.......0.0.......0..0...B
B...0..0.C.....0.0.....C.0..0......0..0.C.....0.0.....C.0..0...B
B...0..0.................0..0......0..0.................0..0...B
B...0..0000.....U.....0000..0......0..0000.....U.....0000..0...B
B...0.X...................T.0......0.X...................T.0...B
B...0.......................0......0.......................0...B
B...0000000000000000000000000......0000000000000000000000000...B
B............C..M..C........................C..M..C............B
B.T.............U.............X..T.............U.............X.B
B.X.............U.............T..X.............U.............T.B
B............C..M..C........................C..M..C............B
B...0000000000000000000000000......0000000000000000000000000...B
B...0.T...................X.0......0.T...................X.0...B
B...0..0000.....U.....0000..0......0..0000.....U.....0000..0...B
B...0..0.................0..0......0..0.................0..0...B
B...0..0.C.....0.0.....C.0..0......0..0.C.....0.0.....C.0..0...B
B...0..0.......0.0.......0..0......0..0.......0.0.......0..0...B
B...0..0.......0.0.......0..0......0..0.......0.0.......0..0...B
B...0.....000000.000000.....0......0.....000000.000000.....0...B
B.M.0..U.......0.0.......U..0.M..M.0..U.......0.0.......U..0.M.B
B...0......00000.00000......0......0......00000.00000......0...B
B...0..0.......0.0.......0..0......0..0.......0.0.......0..0...B
B...0..0.......0.0.......0..0......0..0.......0.0.......0..0...B
B...0..0.C.....0.0.....C.0..0......0..0.C.....0.0.....C.0..0...B
B...0..0.................0..0......0..0.................0..0...B
B...0..0000.....U.....0000..0......0..0000.....U.....0000..0...B
B...0.X...................T.0......0.X...................T.0...B
B...0.......................0......0.......................0...B
B...0000000000000000000000000......0000000000000000000000000...B
B............C..M..C........................C..M..C............B
B.T.............U.............X..T.............U.............X.B
BBBBBBBBBBBBBBBBBBBBBBBBBBBBBBBBBBBBBBBBBBBBBBBBBBBBBBBBBBBBBBBB