BBBBBBBBBBBBBBBBBBBBBBBBBBBBBBBBB
B.X.............U.............T.B
B............C..M..C............B
B...0000000000000000000000000...B
B...0.T...................X.0...B
B...0..0000.....U.....0000..0...B
B...0..0.................0..0...B
B...0..0.C.....0.0.....C.0..0...B
B...0..0.......0.0.......0..0...B
B...0..0.......0.0.......0..0...B
B...0.....000000.000000.....0...B
B...0..U.....1.0.0.2.....U..0...B
B...0......00000.00000......0...B
B...0..0.......0.0.......0..0...B
B...0..0.......0.0.......0..0...B
B...0..0.C.....0.0.....C.0..0...B
B...0..0.................0..0...B
B...0..0000.....U.....0000..0...B
B...0.X...................T.0...B
B...0.......................0...B
B...0000000000000000000000000...B
B............C..M..C............B
B.T.............U.............X.B
BBBBBBBBBBBBBBBBBBBBBBBBBBBBBBBBB